value for money - соотношение цена \ качества
durable - долговечный, прочный
fashionable, trandy, chic - модный
upmarket, expensive, costly, pricey - ориентированный на покупателя с высокими доходами, дорогой
inexpensive, cheap, downmarket - ориентированный на покупателя с низкими доходами
timeless, classic - неустаревающий
cool, great, awesome, sick - классный
sophisticated, cutting-edge, state-of-the-art - передовая технология
well-made - качественный
reliable, trustworthy - надежный
fun - забавный, прикольный

brand image - 
brand loyalty - верность бренду
brand stretching - расширение бренда
brand awareness - узнаваемость бренда
brand name

product launch - запуск продукта
product lifecycle - жизненный цикл продукта
product range - ассортимент товаров
produc placement - реклама товара в фильмах, передачах и т.д.
product endorsement - для рекламы товара исп. известная личность

market leader - лидер рынка
market research - исследование рынка
market share - доля рынка
market challenger - второй конкурирующий товар
market rival, competetor - конкурент
market segment - сегмент рынка

consumer - потребитель
costomer - покупатель

it's way bigger than - на порядок больше, чем
to enable smb to do smth - позволять кому-то делать что-то
to convey information - передать информацию
perception - восприятие, ощущение, осознание.
a raft of data/information/ - целый ряд данных/информрации.
a master brand/key/class/switch/plan/etc. - головной бренд/универсальный ключ/мастер-класс/главный выключатель/клавный план.
to choose smth over smth

income braket - доход семьи
priсe-conscious - обращают на что-то внимание
reveal - открывать,показывать, делать что-то достоянием гласности
i don't see any reasons
prospective - потенциальный
reckon = I think	
company = firm = a business

Homework: p. 13, photo
labour - труд, работа
high-volume - массовый
Fair enough, ... - довольно справедливо
I suppose you've got a point there - Что-то в этом есть...
I take a slightly different view on this 

I'm sorry, but that's out of the question - Об этом не может быть и речи
That's ridiculous - Это смешно
decide on .. !

to put in the me-too category - поставить компанию в ту же самую категорю (эта компания будет как все)

aspirational - вдохновляющий
to commute / commuter - Балашиха - Москва

room - место
lost or delayed luggage
long queues in chek-in
baggage trolley - тележка для багажа
overbooking of seats - больше билетов чем мест
jet-lag - усталость после перелета

divert - отклонять

flight number - ручная кладь
had luggage - ручная кладь
run way - взлетная полоса
terminal - 
at the checking desk - 
carousel - 
fasten your seat belt - престегните ремни
put your seat in the upright position - установите спинки кресел 