to serve as an apprentice - служить подмастерьем;
horsepower - лошадиная сила;
to set about to do smth. - предпри нимать шаги, начинать;
to set footh - излагать;
to constitute the real market for some product - создавать реальный рынок для какого-либо продукта;
all-around service - всестороннее обслуживание;
a foe of monopolies - враг моноплий;
a chassis - шасси;
to roll off the assembly line - сходить с конвейера;
triple - утроить;
accomplishments - достижения;
through neutral mediation - с помощью нейтрального посредничества;
to contribute to the demise of agrarian life - делать вклад в уничтожение аграрного общества;
stylish - шикарный;
to a great extent - в огромной степени;
a controlversial figure - противоречивая фигура;
to be defeated - быть побежденным;
to ridicule  smb - высмеивать;
obsession - навязчивая идея;
evaluative - оценочный;
derivative product - производный продукт;
to glorify the slaughter - прославлять кровопролитие;
literally - в полном смысле слова, без преувеличения;
to collapse - потерпеть крах;
to accumulate - накапливать;
in terms of a product - что касается продукта;

to revolutionize - произвести революцию;
humble farming background - скромное фермерское происхождение;
internal combustion engine - двигатель внутреннего сгорания;
to become completely knowledgeable - стать полностью просвещенным;
to buy the biggest dollar’s worth of quality - платить максимальную цену за качество;
to meet a demand - удовлетворить спрос;
pricing on what the traffic will bear - ценообразование, которое выдержит рынок;
pricing on what it costs to manufacture -  ценообразование, которое равно стоимости производства;
the champion of the common man - защитник простых людей;
boxy - квадратный;
tinny-looking - похожий на консервную банку;
mass production assembly line - сборочный конвеер массового производства;
to conduct a test - проводить тестирование;
to fit in well with smth. - хорошо вписываться;
to discourage war - препядствовать войне;
self-reliance - уверенный в своих силах;
to muss up smb.’s mind - забивать голову;
to unionize - объединять в профсоюз;
a curse - проклятье;
to dramatize the value of human incentives - преувеличивать человеческие стимулы;
to lose the common touch -  терять чувство локтя;
to dehumanize - обесчеловечивать;
parched guest - гости, которых мучает жажда;
to feature - уделять большое внимание;
to fiddle with - возиться  с;
a colorful figure - яркая личность;
within the purchasing power - в пределах покупательской способности;
at hand - под рукой;
charitable causes - благотворительные цели;
collective bargaining - коллективный договор;

the cure for all ills - лекарство от всех болезней
medecine for every disease

the momentary caprise  - мимолетный каприз, мимолетная прихоть
the passing whim

to restrict smb's freedom - ограничивать свободу
to limit smb opportunities

real hero - настоящий герой
genuine hero 

to leave smb behind in sales  - оставлять позади
to surpass smb in sales

to be big on - любить, увлекаться
to be fond of

close to - похожий на
akin to 

would-be - возможный, потенциальный;
potential

stylish - роскошный
luxurious - роскошный

apprientice - pupil - ученик 
studen?t

to set about to do smth - начинать, делать шаги
to start, to begin

to set footh - излагать
to explain

foe - враг
enemy

accomplishment - достижения
achievment

self-relience - самоуверенный
self-confidence

humble - скромный
shy, timid

to accumulate - накапливать
to save 

to redicule  - высмеивать
to make fun of

to reduce the cost - снижать цену
to cut a price 

obsession - навязчивая идея
fixed-idea

to get rid of - избавиться, отказаться от
to throw overboard

dedication - приверженность
comitment